###########
#E        #
# ### ### #
#   # #   #
# # ### ###
#     #   #
# ### ### #
#        S#
###########
