#############################
#E                          #
## ########## ########### ###
#       #             ###   #
### # ########## ###  #### ##
#   #      #      ##   #    #
# ########## #### #####    ##
#   #         # #          ##
# ########### # # ########  #
# #         #   #           #
# # ########### #####   #####
# #             #           #
#################  ##########
#                          S#
#############################
